############################################
##              ######         #############
## ############      # ####### #############
##        ##### #### # #######  ############
########  ##### #### # E   #### ############
####     ########### ##### ####          ###
#### ###         ###       ############# ###
####   ######### ####################### ###
###### ######### #############           ###
######      #### ############# #############
########### ####               #############
########### #### ############# #############
######       ### ############# #############
###### ######### ######        #############
###### ################ ####################
####             #####             #########
#### ##### ########### ########### #########
#### ##### ###########       #   # #########
#### ##### ############### # # # # #########
#### #####           ######   #     ########
#### ############## ############# ##########
#### ############## #####         ##########
#### ############## ##### ##################
#### ######         ##### ##################
#### ############## #####        ###    ####
#### ############## ############ ### ## ####
#### ##############           ## ### ## ####
#### ######################## ## ### ## ####
#### ###########        ##### ##     ## ####
#### ########### ############ ######### ####
####             #####S       ####        ##
#### ############################# #########
####             ################# #########
#### ################ ############ #########
#### ################ ############ #########
####                               #########
#### #######################################
#### #######################################
############################################