############################################
############################################
############################################
############################################
############################################
############################################
############################################
############################################
############################################
############################################
################               #############
################ ############# #############
################ ############# #############
################ ######        #############
####################### ####################
####             #####       E     #########
#### ##### ########### ########### #########
#### ##### ###########       #   # #########
#### ##### ############### # # # # #########
#### #####           ######   #     ########
#### ############## ############# ##########
#### ############## #####         ##########
#### ############## ##### ##################
#### ######         ##### ##################
#### ############## #####        ###    ####
#### ############## ############ ### ## ####
#### ##############           ## ### ## ####
#### ######################## ## ### ## ####
#### ###########        ##### ##     ## ####
#### ########### ############ ######### ####
####             #####S       ####        ##
#### ############################# #########
####             ################# #########
#### ################ ############ #########
#### ################ ############ #########
####                               #########
#### #######################################
#### #######################################
############################################