###########
## ####E###
## #### ###
## #### ###
S       ###
###########