######################################
#### #############          ##########
####               ### ####          #
############# ## ##### ############# #
##      E     ## ##### #####         #
## ############# ##      ########### #
##         ##### ## #### ###         #
### ## ######### ## ## # ### #########
###  #              #  # ###        ##
#### ###### ############ ########## ##
########### #####        ######     ##
###      ##       ############# ######
# ###### ## ##### #####         ######
#    ### ##     # ##### ######  ######
# ###### ######## ##### ##############
#                              S    ###
######################################