##      ###
## #### ###
##   E# ###
####### ###
S       ###
###########